1111111111111
1M010000000C1
1CM00111110E1
100P11E0000M1
1111111111111