1111111111111111111111111111111111
1EM000000000000C00000C000000000001
1010010100100000101001000000010101
1010010M101M10100010M10000000101M1
1P0000000C00C0000000000000000000C1
1111111111111111111111111111111111